PDF=Documents/PDF Files
DOC=Documents/Word Files
DOCX=Documents/Word Files
TXT=Documents/Text Files
XLS=Documents/Excel Files
XLSX=Documents/Excel Files
XLSB=Documents/Excel Files
PPT=Documents/PowerPoint Files
PPTX=Documents/PowerPoint Files
ODT=Documents/OpenDocument Files
ODS=Documents/OpenDocument Files
CSV=Documents/CSV Files
RTF=Documents/Text Files
MD=Documents/Markdown Files
LOG=Documents/Log Files
EPUB=Documents/eBooks
MOBI=Documents/eBooks
CBZ=Documents/Comic Books
CBR=Documents/Comic Books

JPG=Images/JPG Images
JPEG=Images/JPG Images
PNG=Images/PNG Images
GIF=Images/GIF Images
BMP=Images/BMP Images
SVG=Images/SVG Images
WEBP=Images/WEBP Images
TIFF=Images/TIFF Images
ICO=Images/Icon Files
HEIC=Images/HEIC Images
RAW=Images/RAW Images
CR2=Images/RAW Images
NEF=Images/RAW Images
ARW=Images/RAW Images
DNG=Images/RAW Images

MP4=Videos/MP4 Videos
MKV=Videos/MKV Videos
AVI=Videos/AVI Videos
MOV=Videos/MOV Videos
WMV=Videos/WMV Videos
FLV=Videos/FLV Videos
WEBM=Videos/WEBM Videos
MPEG=Videos/MPEG Videos
MPG=Videos/MPEG Videos
3GP=Videos/3GP Videos
M4V=Videos/M4V Videos
TS=Videos/TS Videos
VOB=Videos/VOB Videos
OGV=Videos/OGV Videos
F4V=Videos/F4V Videos

MP3=Audio/MP3 Audio
WAV=Audio/WAV Audio
AAC=Audio/AAC Audio
FLAC=Audio/FLAC Audio
OGG=Audio/OGG Audio
M4A=Audio/M4A Audio
WMA=Audio/WMA Audio
AMR=Audio/AMR Audio
AIF=Audio/AIF Audio
AIFF=Audio/AIF Audio
APE=Audio/APE Audio
OPUS=Audio/OPUS Audio
MID=Audio/MIDI Audio
MIDI=Audio/MIDI Audio

ZIP=Archives/ZIP Archives
RAR=Archives/RAR Archives
7Z=Archives/7Z Archives
TAR=Archives/TAR Archives
GZ=Archives/GZ Archives
BZ2=Archives/BZ2 Archives
XZ=Archives/XZ Archives
ISO=Archives/ISO Archives
CAB=Archives/CAB Archives
ARJ=Archives/ARJ Archives
LZH=Archives/LZH Archives
ACE=Archives/ACE Archives
Z=Archives/Z Archives
JAR=Archives/JAR Archives

PY=Code/Python
JS=Code/JavaScript
JAVA=Code/Java
CPP=Code/C++
C=Code/C
CS=Code/CSharp
HTML=Code/HTML
CSS=Code/CSS
PHP=Code/PHP
RB=Code/Ruby
GO=Code/Go
RS=Code/Rust
TS=Code/TypeScript
SH=Code/Shell
BAT=Code/Batch
PL=Code/Perl
SWIFT=Code/Swift
KOTLIN=Code/Kotlin
SCALA=Code/Scala
R=Code/R
IPYNB=Code/Jupyter
JSON=Code/JSON
XML=Code/XML
YML=Code/YAML
YAML=Code/YAML
ASP=Code/ASP
ASPX=Code/ASP.NET
VBS=Code/VBScript
SQL=Code/SQL
LUA=Code/Lua
H=Code/C-Headers
HPP=Code/C++-Headers

EXE=Applications/Windows Executables
MSI=Applications/Windows Installers
APK=Applications/Android Packages
APPX=Applications/Windows App Packages
DMG=Applications/Mac Installers
PKG=Applications/Mac Packages
APP=Applications/Mac Apps
IPA=Applications/iOS Apps

TTF=Fonts/TrueType
OTF=Fonts/OpenType
FON=Fonts/Bitmap
WOFF=Fonts/Web Open Font
WOFF2=Fonts/Web Open Font 2
EOT=Fonts/Embedded OpenType
PFA=Fonts/PostScript
PFB=Fonts/PostScript

KEY=Presentations/Keynote
ODP=Presentations/OpenDocument
NUMBERS=Spreadsheets/Numbers
XLSM=Spreadsheets/Excel Macro

AI=VectorGraphics/Illustrator
EPS=VectorGraphics/EPS
CDR=VectorGraphics/CorelDRAW
PSD=VectorGraphics/Photoshop